211111111111111111112
100000000000000000001
100000000000000000001
100000000000111110001
100000000000000010001
100000000000000010001
100000000000000010001
100000000000000010001
100000000000000000001
100000000000000000001
100000000000000000001
100000000000000000001
100000000000000000001
100010000000000000001
100010000000000000001
100010000000000000001
100010000000000000001
100011111000000000001
100000000000000000001
100000000000000000001
211111111111111111112
