211121111111111121112
100010000000000010001
100010000000000010001
100010000000000010001
100010000000000010001
100010000000000010001
100010000000000010001
100010000000000010001
100000000000000000001
100000000000000000001
100000001000000000001
100000001000000000001
100000001000000000001
100000001000100000001
100000001000100000001
100000001000100000001
100000001000100000001
100000001000100000001
100000001000100000001
100000001000100000001
211111112111211111112
